; another test file

; 6 levels
; blablabla
; bla

#####
#.$@#
#####
; 1
; blabla

######
#. $@#
######
; 2

#####
#   #
#$  #
#. @#
#####
; 3

######
#.$  #
#.$  #
#.$ @#
######
; 4
